Baron Sengir	U1
Black Carriage	U1
Broken Visage	U1
Cemetery Gate	C2
Drudge Spell	U3
Dry Spell	C2
Feast of the Unicorn	C2
Funeral March	C1
Ghost Hounds	U3
Grandmother Sengir	U1
Greater Werewolf	C1
Headstone	C1
Ihsan's Shade	U3
Irini Sengir	U3
Koskun Falls	U1
Sengir Autocrat	U1
Sengir Bats	C2
Timmerian Fiends	U1
Torture	C2
Veldrane of Sengir	U1
Aether Storm	U3
Baki's Curse	U1
Chain Stasis	U1
Coral Reef	C1
Dark Maze	C2
Forget	U1
Giant Albatross	C2
Giant Oyster	U3
Jinx	C1
Labyrinth Minotaur	C2
Marjhan	U1
Memory Lapse	C2
Merchant Scroll	C1
Mystic Decree	U1
Narwhal	U1
Reef Pirates	C2
"Reveka, Wizard Savant"	U1
Sea Sprite	U3
Sea Troll	U3
Wall of Kelp	U1
An-Havva Constable	U1
An-Havva Inn	U3
Autumn Willow	U1
Carapace	C2
Daughter of Autumn	U1
Faerie Noble	U1
Folk of An-Havva	C2
Hungry Mist	C2
Joven's Ferrets	C1
Leaping Lizard	C1
Mammoth Harness	U1
Primal Order	U1
Renewal	C1
Root Spider	U3
Roots	U3
Rysorian Badger	U1
Shrink	C2
Spectral Bears	U3
Willow Faerie	C2
Willow Priestess	U1
Aliban's Tower	C2
Ambush	C1
Ambush Party	C2
Anaba Ancestor	U1
Anaba Bodyguard	C2
Anaba Shaman	C2
Anaba Spirit Crafter	U1
An-Zerrin Ruins	U1
Chandler	C1
Dwarven Pony	U1
Dwarven Sea Clan	U1
Dwarven Trader	C2
Eron the Relentless	U3
Evaporate	U3
Heart Wolf	U1
Ironclaw Curse	U1
Joven	C1
Orcish Mine	U3
Retribution	U3
Winter Sky	U1
Abbey Gargoyles	U3
Abbey Matron	C2
Aysen Bureaucrats	C2
Aysen Crusader	U1
Aysen Highway	U1
Beast Walkers	U1
Death Speakers	U3
Hazduhr the Abbot	U1
Leeches	U1
Mesa Falcon	C2
Prophecy	C1
Rashka the Slayer	U3
Samite Alchemist	C2
Serra Aviary	U1
Serra Bestiary	C1
Serra Inquisitors	U3
Serra Paladin	C1
Soraya the Falconer	U1
Trade Caravan	C2
Truce	U1
Apocalypse Chime	U1
Clockwork Gnomes	C1
Clockwork Steed	C1
Clockwork Swarm	C1
Didgeridoo	U1
Ebony Rhino	C1
Feroz's Ban	U1
Joven's Tools	U3
Roterothopter	C1
Serrated Arrows	C1
An-Havva Township	U3
Aysen Abbey	U3
Castle Sengir	U3
Koskun Keep	U3
Wizards' School	U3